-	ー
;	っ
a	あ
ba	ば
bd	べん
be	べ
bh	ぶう
bi	び
bj	ぶん
bk	びん
bl	ぼん
bo	ぼ
bp	ぼう
bq	ばい
bu	ぶ
bw	べい
bya	びゃ
byh	びゅう
byo	びょ
byp	びょう
byu	びゅ
bz	ばん
ca	ちゃ
cd	ちぇん
ce	ちぇ
cf	ちぇ
ch	ちゅう
cj	ちゅん
cl	ちょん
co	ちょ
cp	ちょう
cq	ちゃい
cu	ちゅ
cw	ちぇい
cz	ちゃん
da	だ
dd	でん
de	で
df	で
dh	づう
di	ぢ
dj	づん
dk	ぢん
dl	どん
dn	だん
do	ど
dp	どう
dq	だい
du	づ
dw	でい
dya	ぢゃ
dyh	ぢゅう
dyo	ぢょ
dyp	ぢょう
dyu	ぢゅ
dz	だん
e	え
fa	ふぁ
fe	ふぇ
fh	ふう
fi	ふぃ
fj	ふん
fn	ふぁん
fo	ふぉ
fq	ふぁい
fu	ふ
ga	が
gd	げん
ge	げ
gh	ぐう
gi	ぎ
gj	ぐん
gk	ぎん
gl	ごん
gn	がん
go	ご
gp	ごう
gq	がい
gu	ぐ
gw	げい
gya	ぎゃ
gyh	ぎゅう
gyo	ぎょ
gyp	ぎょう
gyu	ぎゅ
ha	は
hd	へん
he	へ
hga	ひゃ
hgh	ひゅう
hgj	ひゅん
hgl	ひょん
hgn	ひゃん
hgo	ひょ
hgp	ひょう
hgu	ひゅ
hi	ひ
hk	ひん
hl	ほん
ho	ほ
hp	ほう
hq	はい
hw	へい
hz	はん
i	い
ja	じゃ
je	じぇ
jf	じゅ
jh	じゅう
ji	じ
jj	じゅん
jo	じょ
jp	じょう
ju	じゅ
ka	か
kd	けん
ke	け
kf	き
kga	きゃ
kge	きぇ
kgh	きゅう
kgj	きゅん
kgl	きょん
kgn	きゃん
kgo	きょ
kgp	きょう
kgq	きゃい
kgu	きゅ
kgw	きぇい
kh	くう
ki	き
kj	くん
kk	きん
kl	こん
ko	こ
kp	こう
kq	かい
ku	く
kw	けい
kz	かん
la	ぁ
le	ぇ
li	ぃ
lo	ぉ
lu	ぅ
lwa	ゎ
lya	ゃ
lyo	ょ
lyu	ゅ
ma	ま
md	めん
me	め
mf	む
mga	みゃ
mgh	みゅう
mgj	みゅん
mgl	みょん
mgn	みゃん
mgo	みょ
mgp	みょう
mgq	みゃい
mgu	みゅ
mgw	みぇい
mh	むう
mi	み
mj	むん
mk	みん
ml	もん
mo	も
mp	もう
mq	まい
mu	む
mw	めい
mz	まん
na	な
nd	ねん
ne	ね
nf	ぬ
nh	ぬう
ni	に
nj	ぬん
nk	にん
nl	のん
no	の
np	のう
nq	ない
nu	ぬ
nw	ねい
nga	にゃ
ngh	にゅう
ngj	にゅん
ngl	にょん
ngo	にょ
ngp	にょう
ngq	にゃい
ngu	にゅ
ngw	にぇい
ngz	にゃん
nz	なん
o	お
pa	ぱ
pd	ぺん
pe	ぺ
pga	ぴゃ
pgh	ぴゅう
pgj	ぴゅん
pgl	ぴょん
pgn	ぴゃん
pgo	ぴょ
pgp	ぴょう
pgu	ぴゅ
ph	ぷう
pi	ぴ
pj	ぷん
pk	ぴん
pl	ぽん
po	ぽ
pp	ぽう
pq	ぱい
pu	ぷ
pw	ぺい
pz	ぱん
q	ん
ra	ら
rd	れん
re	れ
rh	るう
ri	り
rj	るん
rk	りん
rl	ろん
rn	らん
ro	ろ
rp	ろう
rq	らい
ru	る
rw	れい
rya	りゃ
ryh	りゅう
ryo	りょ
ryp	りょう
ryu	りゅ
sa	さ
sd	せん
se	せ
sh	すう
si	し
sj	すん
sk	しん
sl	そん
sn	さん
so	そ
sp	そう
sq	さい
su	す
sw	せい
ta	た
td	てん
te	て
th	つう
ti	ち
tj	つん
tk	ちん
tl	とん
tn	たん
to	と
tp	とう
tq	たい
tu	つ
tw	てい
u	う
vu	ヴ
vz	ヴぁん
wa	わ
wn	わん
wo	を
wq	わい
xa	しゃ
xd	しぇん
xh	しゅう
xj	しゅん
xl	しょん
xo	しょ
xp	しょう
xq	しゃい
xu	しゅ
xw	しぇい
xz	しゃん
ya	や
yf	ゆ
yh	ゆう
yj	ゆん
yl	よん
yo	よ
yp	よう
yu	ゆ
yz	やん
za	ざ
zd	ぜん
ze	ぜ
zh	ずう
zj	ずん
zk	じん
zl	ぞん
zn	ざん
zo	ぞ
zp	ぞう
zq	ざい
zu	ず
zw	ぜい